11111111
100000c1
10010001
11000111
10011101
110m0101
10010001
11111111